1111111111
10C00100P1
1000100001
1E00100001
1111111111