1111111111
10C00100P1
100CCCC001
10110C1E01
1111111111