1111111111
1PC0010001
1000E00C11
1010C01001
1111111111