1111111111
1PC0010001
1000000C11
1011C010E1
1111111111