1111111111
1PC0010001
1CCCEC0C11
101CCC1CC1
1111111111