1111111111
1PCCC1CCC1
1CCCEC0C11
1CCCCCCCC1
1111111111