1111111111
10C0010001
10000P0C11
1011C010E1
1111111111