111111111111111111111111
100000101010110111C100E1
110110100000000000000101
110110001101011101111101
1C00101C000100C000000101
111010111101011010110101
100000000001010000000001
110111010101000101011101
11010001010101010101C101
100001010000000001010001
111011010111110101000101
100000000000000100010101
1P110101101C110001010001
111111111111111111111111